每日指标
接口：daily_basic
名称	类型	描述
ts_code	str	TS股票代码
trade_date	str	交易日期
close	float	当日收盘价
turnover_rate	float	换手率（%）
turnover_rate_f	float	换手率（自由流通股）
volume_ratio	float	量比
pe	float	市盈率（总市值/净利润）
pe_ttm	float	市盈率（TTM）
pb	float	市净率（总市值/净资产）
ps	float	市销率
ps_ttm	float	市销率（TTM）
total_share	float	总股本 （万股）
float_share	float	流通股本 （万股）
free_share	float	自由流通股本 （万）
total_mv	float	总市值 （万元）
circ_mv	float	流通市值（万元）


日线行情
接口：daily
名称	类型	描述
ts_code	str	股票代码
trade_date	str	交易日期
open	float	开盘价
high	float	最高价
low	float	最低价
close	float	收盘价
pre_close	float	昨收价
change	float	涨跌额
pct_chg	float	涨跌幅 （未复权，如果是复权请用 通用行情接口 ）
vol	float	成交量 （手）
amount	float	成交额 （千元）




财务指标数据
接口：fina_indicator
名称	类型	默认显示	描述
ts_code	str	Y	TS代码
ann_date	str	Y	公告日期
end_date	str	Y	报告期
eps	float	Y	基本每股收益
dt_eps	float	Y	稀释每股收益
capital_rese_ps	float	Y	每股资本公积
undist_profit_ps	float	Y	每股未分配利润
gross_margin	float	Y	毛利
bps	float	Y	每股净资产
roe	float	Y	净资产收益率
roe_waa	float	Y	加权平均净资产收益率
roe_dt	float	Y	净资产收益率(扣除非经常损益)